 101,  0, 31, 34, 63, 0, 0                                                                                                            
 101,  1, 31, 34, 63, 0, 1                                                                                                            
 101,  2, 31, 34, 63, 0, 2                                                                                                            
 101,  3, 31, 34, 63, 0, 3                                                                                                            
 101,  4, 31, 34, 63, 0, 4                                                                                                            
 101,  5, 31, 34, 63, 0, 5                                                                                                            
 101,  6, 31, 34, 63, 0, 6                                                                                                            
 101,  7, 31, 34, 63, 0, 7                                                                                                            
 101,  8, 31, 34, 63, 0, 8                                                                                                            
 101,  9, 31, 34, 63, 0, 9                                                                                                            
 101, 10, 31, 34, 63, 0,10                                                                                                            
 101, 11, 31, 34, 63, 0,11                                                                                                            
 101, 12, 31, 34, 63, 0,12                                                                                                            
 101, 13, 31, 34, 63, 0,13                                                                                                            
 101, 14, 31, 34, 63, 0,14                                                                                                            
 101, 15, 31, 34, 63, 0,15                                                                                                            
 101, 16, 31, 34, 63, 0,16                                                                                                            
 101, 17, 31, 34, 63, 0,17                                                                                                            
 101, 18, 31, 34, 63, 0,18                                                                                                            
 101, 19, 31, 34, 63, 0,19                                                                                                            
 101, 20, 31, 34, 63, 0,20                                                                                                            
 101, 21, 31, 34, 63, 0,21                                                                                                            
 101, 22, 31, 34, 63, 0,22                                                                                                            
 101, 23, 31, 34, 63, 0,23                                                                                                            
 101, 24, 31, 34, 63, 0,24                                                                                                            
 101, 25, 31, 34, 63, 0,25                                                                                                            
 101, 26, 31, 34, 63, 0,26                                                                                                            
 101, 27, 31, 34, 63, 0,27                                                                                                            
 101, 28, 31, 34, 63, 0,28                                                                                                            
 101, 29, 31, 34, 63, 0,29                                                                                                            
 101, 30, 31, 34, 63, 0,30                                                                                                            
 101, 31, 31, 34, 63, 0,31                                                                                                            
 111,  0,  2, 13, 61, 0, 0                                                                                                                                      
   