201     0    0   8  61  0  0 
201     1    0   8  61  0  1 
201     2    0   8  61  0  2 
201     3    0   8  61  0  3 
201     4    0   8  61  0  4 
201     5    0   8  61  0  5 
201     6    0   8  61  0  6 
201     7    0   8  61  0  7 
201     8    0   8  61  0  8 
201     9    0   8  61  0  9 
201    10    0   8  61  0  10 
201    11    0   8  61  0  11 
201    12    0   8  61  0  12 
201    13    0   8  61  0  13 
201    14    0   8  61  0  14 
201    15    0   8  61  0  15 
201    16    0   8  61  0  16 
201    17    0   8  61  0  17 
201    18    0   8  61  0  18 
201    19    0   8  61  0  19 
201    20    0   8  61  0  20 
201    21    0   8  61  0  21 
201    22    0   8  61  0  22 
201    23    0   8  61  0  23 
201    24    0   8  61  0  24 
201    25    0   8  61  0  25 
201    26    0   8  61  0  26 
201    27    0   8  61  0  27 
201    28    0   8  61  0  28 
201    29    0   8  61  0  29 
201    30    0   8  61  0  30 
201    31    0   8  61  0  31 
