20     0   31  34  61  0  0 
20     1   31  34  61  0  1 
20     2   31  34  61  0  2 
20     3   31  34  61  0  3 
20     4   31  34  61  0  4 
20     5   31  34  61  0  5 
20     6   31  34  61  0  6 
20     7   31  34  61  0  7 
20     8   31  34  61  0  8 
20     9   31  34  61  0  9 
20    10   31  34  61  0  10 
20    11   31  34  61  0  11 
20    12   31  34  61  0  12 
20    13   31  34  61  0  13 
20    14   31  34  61  0  14 
20    15   31  34  61  0  15 
20    16   31  34  61  0  16 
20    17   31  34  61  0  17 
20    18   31  34  61  0  18 
20    19   31  34  61  0  19 
20    20   31  34  61  0  20 
20    21   31  34  61  0  21 
20    22   31  34  61  0  22 
20    23   31  34  61  0  23 
20    24   31  34  61  0  24 
20    25   31  34  61  0  25 
20    26   31  34  61  0  26 
20    27   31  34  61  0  27 
20    28   31  34  61  0  28 
20    29   31  34  61  0  29 
20    30   31  34  61  0  30 
20    31   31  34  61  0  31 
