19     0   31  34  63  0  0 
19     1   31  34  63  0  1 
19     2   31  34  63  0  2 
19     3   31  34  63  0  3 
19     4   31  34  63  0  4 
19     5   31  34  63  0  5 
19     6   31  34  63  0  6 
19     7   31  34  63  0  7 
19     8   31  34  63  0  8 
19     9   31  34  63  0  9 
19    10   31  34  63  0  10 
19    11   31  34  63  0  11 
19    12   31  34  63  0  12 
19    13   31  34  63  0  13 
19    14   31  34  63  0  14 
19    15   31  34  63  0  15 
19    16   31  34  63  0  16 
19    17   31  34  63  0  17 
19    18   31  34  63  0  18 
19    19   31  34  63  0  19 
19    20   31  34  63  0  20 
19    21   31  34  63  0  21 
19    22   31  34  63  0  22 
19    23   31  34  63  0  23 
19    24   31  34  63  0  24 
19    25   31  34  63  0  25 
19    26   31  34  63  0  26 
19    27   31  34  63  0  27 
19    28   31  34  63  0  28 
19    29   31  34  63  0  29 
19    30   31  34  63  0  30 
19    31   31  34  63  0  31 
