19     0    0   0  61  0  0 
19     1    0   0  61  0  1 
19     2    0   0  61  0  2 
19     3    0   0  61  0  3 
19     4    0   0  61  0  4 
19     5    0   0  61  0  5 
19     6    0   0  61  0  6 
19     7    0   0  61  0  7 
19     8    0   0  61  0  8 
19     9    0   0  61  0  9 
19    10    0   0  61  0  10 
19    11    0   0  61  0  11 
19    12    0   0  61  0  12 
19    13    0   0  61  0  13 
19    14    0   0  61  0  14 
19    15    0   0  61  0  15 
19    16    0   0  61  0  16 
19    17    0   0  61  0  17 
19    18    0   0  61  0  18 
19    19    0   0  61  0  19 
19    20    0   0  61  0  20 
19    21    0   0  61  0  21 
19    22    0   0  61  0  22 
19    23    0   0  61  0  23 
19    24    0   0  61  0  24 
19    25    0   0  61  0  25 
19    26    0   0  61  0  26 
19    27    0   0  61  0  27 
19    28    0   0  61  0  28 
19    29    0   0  61  0  29 
19    30    0   0  61  0  30 
19    31    0   0  61  0  31 
