101    0   32  32  63  0   0 
101    1   32  32  63  0   1 
101    2   32  32  63  0   2 
101    3   32  32  63  0   3 
101    4   32  32  63  0   4 
101    5   32  32  63  0   5 
101    6   32  32  63  0   6 
101    7   32  32  63  0   7 
101    8   32  32  63  0   8 
101    9   32  32  63  0   9 
101   10   32  32  63  0  10 
101   11   32  32  63  0  11 
101   12   32  32  63  0  12 
101   13   32  32  63  0  13 
101   14   32  32  63  0  14 
101   15   32  32  63  0  15 
101   16   32  32  63  0  16 
101   17   32  32  63  0  17 
101   18   32  32  63  0  18 
101   19   32  32  63  0  19 
101   20   32  32  63  0  20 
101   21   32  32  63  0  21 
101   22   32  32  63  0  22 
101   23   32  32  63  0  23 
101   24   32  32  63  0  24 
101   25   32  32  63  0  25 
101   26   32  32  63  0  26 
101   27   32  32  63  0  27 
101   28   32  32  63  0  28 
101   29   32  32  63  0  29 
101   30   32  32  63  0  30 
101   31   32  32  63  0  31 
