#map for S2 MWDC upstream sh13
# X'
24,  0, 11, 22, 31, 0, 95  
24,  1, 11, 22, 31, 0, 94  
24,  2, 11, 22, 31, 0, 93  
24,  3, 11, 22, 31, 0, 92  
24,  4, 11, 22, 31, 0, 79  
24,  5, 11, 22, 31, 0, 78  
24,  6, 11, 22, 31, 0, 77  
24,  7, 11, 22, 31, 0, 76  
24,  8, 11, 22, 31, 0, 91  
24,  9, 11, 22, 31, 0, 90  
24, 10, 11, 22, 31, 0, 89  
24, 11, 11, 22, 31, 0, 88  
24, 12, 11, 22, 31, 0, 75  
24, 13, 11, 22, 31, 0, 74  
24, 14, 11, 22, 31, 0, 73  
24, 15, 11, 22, 31, 0, 72  
24, 16, 11, 22, 31, 0, 123  
24, 17, 11, 22, 31, 0, 122  
24, 18, 11, 22, 31, 0, 121  
24, 19, 11, 22, 31, 0, 120  
24, 20, 11, 22, 31, 0, 107  
24, 21, 11, 22, 31, 0, 106  
24, 22, 11, 22, 31, 0, 105  
24, 23, 11, 22, 31, 0, 104
# X
24, 24, 11, 22, 31, 0, 63  
24, 25, 11, 22, 31, 0, 62  
24, 26, 11, 22, 31, 0, 61  
24, 27, 11, 22, 31, 0, 60  
24, 28, 11, 22, 31, 0, 47  
24, 29, 11, 22, 31, 0, 46  
24, 30, 11, 22, 31, 0, 45  
24, 31, 11, 22, 31, 0, 44  
24, 32, 11, 22, 31, 0, 59  
24, 33, 11, 22, 31, 0, 58  
24, 34, 11, 22, 31, 0, 57  
24, 35, 11, 22, 31, 0, 56  
24, 36, 11, 22, 31, 0, 43  
24, 37, 11, 22, 31, 0, 42  
24, 38, 11, 22, 31, 0, 41  
24, 39, 11, 22, 31, 0, 40  
24, 40, 11, 22, 31, 0, 127  
24, 41, 11, 22, 31, 0, 126  
24, 42, 11, 22, 31, 0, 125  
24, 43, 11, 22, 31, 0, 124  
24, 44, 11, 22, 31, 0, 111  
24, 45, 11, 22, 31, 0, 110  
24, 46, 11, 22, 31, 0, 109  
24, 47, 11, 22, 31, 0, 108  
# U
24, 48, 11, 22, 31, 0, 87  
24, 49, 11, 22, 31, 0, 86   
24, 50, 11, 22, 31, 0, 85   
24, 51, 11, 22, 31, 0, 84   
24, 52, 11, 22, 31, 0, 71   
24, 53, 11, 22, 31, 0, 70   
24, 54, 11, 22, 31, 0, 69   
24, 55, 11, 22, 31, 0, 68   
24, 56, 11, 22, 31, 0, 83   
24, 57, 11, 22, 31, 0, 82   
24, 58, 11, 22, 31, 0, 81   
24, 59, 11, 22, 31, 0, 80   
24, 60, 11, 22, 31, 0, 67   
24, 61, 11, 22, 31, 0, 66   
24, 62, 11, 22, 31, 0, 65   
24, 63, 11, 22, 31, 0, 64   
24, 64, 11, 22, 31, 0, 115  
24, 65, 11, 22, 31, 0, 114  
24, 66, 11, 22, 31, 0, 113  
24, 67, 11, 22, 31, 0, 112  
24, 68, 11, 22, 31, 0, 99   
24, 69, 11, 22, 31, 0, 98   
24, 70, 11, 22, 31, 0, 97   
24, 71, 11, 22, 31, 0, 96   
# V
24, 72, 11, 22, 31, 0, 55   
24, 73, 11, 22, 31, 0, 54   
24, 74, 11, 22, 31, 0, 53   
24, 75, 11, 22, 31, 0, 52   
24, 76, 11, 22, 31, 0, 39   
24, 77, 11, 22, 31, 0, 38   
24, 78, 11, 22, 31, 0, 37   
24, 79, 11, 22, 31, 0, 36   
24, 80, 11, 22, 31, 0, 51   
24, 81, 11, 22, 31, 0, 50   
24, 82, 11, 22, 31, 0, 49   
24, 83, 11, 22, 31, 0, 48   
24, 84, 11, 22, 31, 0, 35   
24, 85, 11, 22, 31, 0, 34   
24, 86, 11, 22, 31, 0, 33   
24, 87, 11, 22, 31, 0, 32   
24, 88, 11, 22, 31, 0, 119  
24, 89, 11, 22, 31, 0, 118  
24, 90, 11, 22, 31, 0, 117  
24, 91, 11, 22, 31, 0, 116  
24, 92, 11, 22, 31, 0, 103  
24, 93, 11, 22, 31, 0, 102  
24, 94, 11, 22, 31, 0, 101  
24, 95, 11, 22, 31, 0, 100  

