#map for S2 MWDC upstream 
# X'
24,  0, 11, 22, 31, 1, 95  
24,  1, 11, 22, 31, 1, 94  
24,  2, 11, 22, 31, 1, 93  
24,  3, 11, 22, 31, 1, 92  
24,  4, 11, 22, 31, 1, 79  
24,  5, 11, 22, 31, 1, 78  
24,  6, 11, 22, 31, 1, 77  
24,  7, 11, 22, 31, 1, 76  
24,  8, 11, 22, 31, 1, 91  
24,  9, 11, 22, 31, 1, 90  
24, 10, 11, 22, 31, 1, 89  
24, 11, 11, 22, 31, 1, 88  
24, 12, 11, 22, 31, 1, 75  
24, 13, 11, 22, 31, 1, 74  
24, 14, 11, 22, 31, 1, 73  
24, 15, 11, 22, 31, 1, 72  
24, 16, 11, 22, 31, 1, 123  
24, 17, 11, 22, 31, 1, 122  
24, 18, 11, 22, 31, 1, 121  
24, 19, 11, 22, 31, 1, 120  
24, 20, 11, 22, 31, 1, 107  
24, 21, 11, 22, 31, 1, 106  
24, 22, 11, 22, 31, 1, 105  
24, 23, 11, 22, 31, 1, 104
# X
24, 24, 11, 22, 31, 1, 63  
24, 25, 11, 22, 31, 1, 62  
24, 26, 11, 22, 31, 1, 61  
24, 27, 11, 22, 31, 1, 60  
24, 28, 11, 22, 31, 1, 47  
24, 29, 11, 22, 31, 1, 46  
24, 30, 11, 22, 31, 1, 45  
24, 31, 11, 22, 31, 1, 44  
24, 32, 11, 22, 31, 1, 59  
24, 33, 11, 22, 31, 1, 58  
24, 34, 11, 22, 31, 1, 57  
24, 35, 11, 22, 31, 1, 56  
24, 36, 11, 22, 31, 1, 43  
24, 37, 11, 22, 31, 1, 42  
24, 38, 11, 22, 31, 1, 41  
24, 39, 11, 22, 31, 1, 40  
24, 40, 11, 22, 31, 1, 127  
24, 41, 11, 22, 31, 1, 126  
24, 42, 11, 22, 31, 1, 125  
24, 43, 11, 22, 31, 1, 124  
24, 44, 11, 22, 31, 1, 111  
24, 45, 11, 22, 31, 1, 110  
24, 46, 11, 22, 31, 1, 109  
24, 47, 11, 22, 31, 1, 108  
# U
24, 48, 11, 22, 31, 1, 87  
24, 49, 11, 22, 31, 1, 86   
24, 50, 11, 22, 31, 1, 85   
24, 51, 11, 22, 31, 1, 84   
24, 52, 11, 22, 31, 1, 71   
24, 53, 11, 22, 31, 1, 70   
24, 54, 11, 22, 31, 1, 69   
24, 55, 11, 22, 31, 1, 68   
24, 56, 11, 22, 31, 1, 83   
24, 57, 11, 22, 31, 1, 82   
24, 58, 11, 22, 31, 1, 81   
24, 59, 11, 22, 31, 1, 80   
24, 60, 11, 22, 31, 1, 67   
24, 61, 11, 22, 31, 1, 66   
24, 62, 11, 22, 31, 1, 65   
24, 63, 11, 22, 31, 1, 64   
24, 64, 11, 22, 31, 1, 115  
24, 65, 11, 22, 31, 1, 114  
24, 66, 11, 22, 31, 1, 113  
24, 67, 11, 22, 31, 1, 112  
24, 68, 11, 22, 31, 1, 99   
24, 69, 11, 22, 31, 1, 98   
24, 70, 11, 22, 31, 1, 97   
24, 71, 11, 22, 31, 1, 96   
# V
24, 72, 11, 22, 31, 1, 55   
24, 73, 11, 22, 31, 1, 54   
24, 74, 11, 22, 31, 1, 53   
24, 75, 11, 22, 31, 1, 52   
24, 76, 11, 22, 31, 1, 39   
24, 77, 11, 22, 31, 1, 38   
24, 78, 11, 22, 31, 1, 37   
24, 79, 11, 22, 31, 1, 36   
24, 80, 11, 22, 31, 1, 51   
24, 81, 11, 22, 31, 1, 50   
24, 82, 11, 22, 31, 1, 49   
24, 83, 11, 22, 31, 1, 48   
24, 84, 11, 22, 31, 1, 35   
24, 85, 11, 22, 31, 1, 34   
24, 86, 11, 22, 31, 1, 33   
24, 87, 11, 22, 31, 1, 32   
24, 88, 11, 22, 31, 1, 119  
24, 89, 11, 22, 31, 1, 118  
24, 90, 11, 22, 31, 1, 117  
24, 91, 11, 22, 31, 1, 116  
24, 92, 11, 22, 31, 1, 103  
24, 93, 11, 22, 31, 1, 102  
24, 94, 11, 22, 31, 1, 101  
24, 95, 11, 22, 31, 1, 100  

