#map for S2 MWDC downstream 
#X'
25,  0, 11, 22, 31, 2, 87  
25,  1, 11, 22, 31, 2, 86  
25,  2, 11, 22, 31, 2, 85  
25,  3, 11, 22, 31, 2, 84  
25,  4, 11, 22, 31, 2, 71  
25,  5, 11, 22, 31, 2, 70  
25,  6, 11, 22, 31, 2, 69  
25,  7, 11, 22, 31, 2, 68  
25,  8, 11, 22, 31, 2, 83  
25,  9, 11, 22, 31, 2, 82  
25, 10, 11, 22, 31, 2, 81  
25, 11, 11, 22, 31, 2, 80  
25, 12, 11, 22, 31, 2, 67  
25, 13, 11, 22, 31, 2, 66  
25, 14, 11, 22, 31, 2, 65  
25, 15, 11, 22, 31, 2, 64  
25, 16, 11, 22, 31, 2, 123 
25, 17, 11, 22, 31, 2, 122 
25, 18, 11, 22, 31, 2, 121 
25, 19, 11, 22, 31, 2, 120 
25, 20, 11, 22, 31, 2, 107 
25, 21, 11, 22, 31, 2, 106 
25, 22, 11, 22, 31, 2, 105 
25, 23, 11, 22, 31, 2, 104 
#X
25, 24, 11, 22, 31, 2, 95 
25, 25, 11, 22, 31, 2, 94 
25, 26, 11, 22, 31, 2, 93 
25, 27, 11, 22, 31, 2, 92 
25, 28, 11, 22, 31, 2, 79 
25, 29, 11, 22, 31, 2, 78 
25, 30, 11, 22, 31, 2, 77 
25, 31, 11, 22, 31, 2, 76 
25, 32, 11, 22, 31, 2, 91 
25, 33, 11, 22, 31, 2, 90 
25, 34, 11, 22, 31, 2, 89 
25, 35, 11, 22, 31, 2, 88 
25, 36, 11, 22, 31, 2, 75 
25, 37, 11, 22, 31, 2, 74 
25, 38, 11, 22, 31, 2, 73 
25, 39, 11, 22, 31, 2, 72 
25, 40, 11, 22, 31, 2, 127 
25, 41, 11, 22, 31, 2, 126 
25, 42, 11, 22, 31, 2, 125 
25, 43, 11, 22, 31, 2, 124 
25, 44, 11, 22, 31, 2, 111 
25, 45, 11, 22, 31, 2, 110 
25, 46, 11, 22, 31, 2, 109 
25, 47, 11, 22, 31, 2, 108 
#U
25, 48, 11, 22, 31, 3, 55  
25, 49, 11, 22, 31, 3, 54  
25, 50, 11, 22, 31, 3, 53  
25, 51, 11, 22, 31, 3, 52  
25, 52, 11, 22, 31, 3, 39  
25, 53, 11, 22, 31, 3, 38  
25, 54, 11, 22, 31, 3, 37  
25, 55, 11, 22, 31, 3, 36  
25, 56, 11, 22, 31, 3, 51  
25, 57, 11, 22, 31, 3, 50  
25, 58, 11, 22, 31, 3, 49  
25, 59, 11, 22, 31, 3, 48  
25, 60, 11, 22, 31, 3, 35  
25, 61, 11, 22, 31, 3, 34  
25, 62, 11, 22, 31, 3, 33  
25, 63, 11, 22, 31, 3, 32  
25, 64, 11, 22, 31, 3, 95  
25, 65, 11, 22, 31, 3, 94  
25, 66, 11, 22, 31, 3, 93  
25, 67, 11, 22, 31, 3, 92  
25, 68, 11, 22, 31, 3, 79  
25, 69, 11, 22, 31, 3, 78  
25, 70, 11, 22, 31, 3, 77  
25, 71, 11, 22, 31, 3, 76  
#V    
25, 72, 11, 22, 31, 3, 63  
25, 73, 11, 22, 31, 3, 62  
25, 74, 11, 22, 31, 3, 61  
25, 75, 11, 22, 31, 3, 60  
25, 76, 11, 22, 31, 3, 47  
25, 77, 11, 22, 31, 3, 46  
25, 78, 11, 22, 31, 3, 45  
25, 79, 11, 22, 31, 3, 44  
25, 80, 11, 22, 31, 3, 59  
25, 81, 11, 22, 31, 3, 58  
25, 82, 11, 22, 31, 3, 57  
25, 83, 11, 22, 31, 3, 56  
25, 84, 11, 22, 31, 3, 43  
25, 85, 11, 22, 31, 3, 42  
25, 86, 11, 22, 31, 3, 41  
25, 87, 11, 22, 31, 3, 40  
25, 88, 11, 22, 31, 3, 91  
25, 89, 11, 22, 31, 3, 90  
25, 90, 11, 22, 31, 3, 89  
25, 91, 11, 22, 31, 3, 88  
25, 92, 11, 22, 31, 3, 75  
25, 93, 11, 22, 31, 3, 74  
25, 94, 11, 22, 31, 3, 73  
25, 95, 11, 22, 31, 3, 72  

