# Map file for DC32 
# X
21,  1, 60,0,2,1, 95 
21,  2, 60,0,2,1, 94 
21,  3, 60,0,2,1, 93 
21,  4, 60,0,2,1, 92 
21,  5, 60,0,2,1, 79 
21,  6, 60,0,2,1, 78 
21,  7, 60,0,2,1, 77 
21,  8, 60,0,2,1, 76 
21,  9, 60,0,2,1, 91 
21, 10, 60,0,2,1, 90 
21, 11, 60,0,2,1, 89 
21, 12, 60,0,2,1, 88 
21, 13, 60,0,2,1, 75 
21, 14, 60,0,2,1, 74 
21, 15, 60,0,2,1, 73 
21,  0, 60,0,2,1, 72

# X'
21, 17, 60,0,2,1, 87 
21, 18, 60,0,2,1, 86 
21, 19, 60,0,2,1, 85 
21, 20, 60,0,2,1, 84 
21, 21, 60,0,2,1, 71 
21, 22, 60,0,2,1, 70 
21, 23, 60,0,2,1, 69 
21, 24, 60,0,2,1, 68 
21, 25, 60,0,2,1, 83 
21, 26, 60,0,2,1, 82 
21, 27, 60,0,2,1, 81 
21, 28, 60,0,2,1, 80 
21, 29, 60,0,2,1, 67 
21, 30, 60,0,2,1, 66 
21, 31, 60,0,2,1, 65 
21, 16, 60,0,2,1, 64

# Y
21, 33, 60,0,2,1,127 
21, 34, 60,0,2,1,126 
21, 35, 60,0,2,1,125 
21, 36, 60,0,2,1,124 
21, 37, 60,0,2,1,111 
21, 38, 60,0,2,1,110 
21, 39, 60,0,2,1,109 
21, 40, 60,0,2,1,108 
21, 41, 60,0,2,1,123 
21, 42, 60,0,2,1,122 
21, 43, 60,0,2,1,121 
21, 44, 60,0,2,1,120 
21, 45, 60,0,2,1,107 
21, 46, 60,0,2,1,106 
21, 47, 60,0,2,1,105 
21, 32, 60,0,2,1,104

# Y'
21, 49, 60,0,2,1,119 
21, 50, 60,0,2,1,118 
21, 51, 60,0,2,1,117 
21, 52, 60,0,2,1,116 
21, 53, 60,0,2,1,103 
21, 54, 60,0,2,1,102 
21, 55, 60,0,2,1,101 
21, 56, 60,0,2,1,100 
21, 57, 60,0,2,1,115 
21, 58, 60,0,2,1,114 
21, 59, 60,0,2,1,113 
21, 60, 60,0,2,1,112 
21, 61, 60,0,2,1, 99 
21, 62, 60,0,2,1, 98 
21, 63, 60,0,2,1, 97 
21, 48, 60,0,2,1, 96 

