# Map file for DC32 
# X
21,  1, 0,3,31,1, 97 
21,  2, 0,3,31,1, 99 
21,  3, 0,3,31,1, 113 
21,  4, 0,3,31,1, 115
21,  5, 0,3,31,1, 101
21,  6, 0,3,31,1, 103
21,  7, 0,3,31,1, 117
21,  8, 0,3,31,1, 119
21,  9, 0,3,31,1, 105
21, 10, 0,3,31,1, 107
21, 11, 0,3,31,1, 121
21, 12, 0,3,31,1, 123
21, 13, 0,3,31,1, 109
21, 14, 0,3,31,1, 111
21, 15, 0,3,31,1, 125
21,  0, 0,3,31,1, 127

# X'
21, 17, 0,3,31,1, 65
21, 18, 0,3,31,1, 67 
21, 19, 0,3,31,1, 81 
21, 20, 0,3,31,1, 83 
21, 21, 0,3,31,1, 69 
21, 22, 0,3,31,1, 71 
21, 23, 0,3,31,1, 85 
21, 24, 0,3,31,1, 87 
21, 25, 0,3,31,1, 73 
21, 26, 0,3,31,1, 75 
21, 27, 0,3,31,1, 89 
21, 28, 0,3,31,1, 91 
21, 29, 0,3,31,1, 77 
21, 30, 0,3,31,1, 79 
21, 31, 0,3,31,1, 93 
21, 16, 0,3,31,1, 95

# Y
21, 33, 0,3,31,1,96 
21, 34, 0,3,31,1,98 
21, 35, 0,3,31,1,112 
21, 36, 0,3,31,1,114 
21, 37, 0,3,31,1,100 
21, 38, 0,3,31,1,102 
21, 39, 0,3,31,1,116 
21, 40, 0,3,31,1,118 
21, 41, 0,3,31,1,104 
21, 42, 0,3,31,1,106 
21, 43, 0,3,31,1,120 
21, 44, 0,3,31,1,122 
21, 45, 0,3,31,1,108 
21, 46, 0,3,31,1,110 
21, 47, 0,3,31,1,124 
21, 32, 0,3,31,1,126

# Y'
21, 49, 0,3,31,1,64 
21, 50, 0,3,31,1,66 
21, 51, 0,3,31,1,80 
21, 52, 0,3,31,1,82 
21, 53, 0,3,31,1,68
21, 54, 0,3,31,1,70
21, 55, 0,3,31,1,84
21, 56, 0,3,31,1,86
21, 57, 0,3,31,1,72
21, 58, 0,3,31,1,74
21, 59, 0,3,31,1,88
21, 60, 0,3,31,1,90
21, 61, 0,3,31,1,76
21, 62, 0,3,31,1,78
21, 63, 0,3,31,1,92
21, 48, 0,3,31,1,94

