# Map file for DC32 
# X
21,  0, 11,3,31,2, 65
21,  1, 11,3,31,2, 67 
21,  2, 11,3,31,2, 81 
21,  3, 11,3,31,2, 83 
21,  4, 11,3,31,2, 69 
21,  5, 11,3,31,2, 71 
21,  6, 11,3,31,2, 85 
21,  7, 11,3,31,2, 87 
21,  8, 11,3,31,2, 73 
21,  9, 11,3,31,2, 75 
21, 10, 11,3,31,2, 89 
21, 11, 11,3,31,2, 91 
21, 12, 11,3,31,2, 77 
21, 13, 11,3,31,2, 79 
21, 14, 11,3,31,2, 93 
21, 15, 11,3,31,2, 95
      
    
# X'
21, 16, 11,3,31,2, 97 
21, 17, 11,3,31,2, 99 
21, 18, 11,3,31,2, 113 
21, 19, 11,3,31,2, 115
21, 20, 11,3,31,2, 101
21, 21, 11,3,31,2, 103
21, 22, 11,3,31,2, 117
21, 23, 11,3,31,2, 119
21, 24, 11,3,31,2, 105
21, 25, 11,3,31,2, 107
21, 26, 11,3,31,2, 121
21, 27, 11,3,31,2, 123
21, 28, 11,3,31,2, 109
21, 29, 11,3,31,2, 111
21, 30, 11,3,31,2, 125
21, 31, 11,3,31,2, 127
      
# Y 
21, 32, 11,3,31,2,64 
21, 33, 11,3,31,2,66 
21, 34, 11,3,31,2,80 
21, 35, 11,3,31,2,82 
21, 36, 11,3,31,2,68
21, 37, 11,3,31,2,70
21, 38, 11,3,31,2,84
21, 39, 11,3,31,2,86
21, 40, 11,3,31,2,72
21, 41, 11,3,31,2,74
21, 42, 11,3,31,2,88
21, 43, 11,3,31,2,90
21, 44, 11,3,31,2,76
21, 45, 11,3,31,2,78
21, 46, 11,3,31,2,92
21, 47, 11,3,31,2,94
      
# Y'
21, 48, 11,3,31,2,96 
21, 49, 11,3,31,2,98 
21, 50, 11,3,31,2,112 
21, 51, 11,3,31,2,114 
21, 52, 11,3,31,2,100 
21, 53, 11,3,31,2,102 
21, 54, 11,3,31,2,116 
21, 55, 11,3,31,2,118 
21, 56, 11,3,31,2,104 
21, 57, 11,3,31,2,106 
21, 58, 11,3,31,2,120 
21, 59, 11,3,31,2,122 
21, 60, 11,3,31,2,108 
21, 61, 11,3,31,2,110 
21, 62, 11,3,31,2,124 
21, 63, 11,3,31,2,126













