# Map file for DC32 
21,  0,  11,3,31,1,127
21,  1,  11,3,31,1,126
21,  2,  11,3,31,1,125
21,  3,  11,3,31,1,124
21,  4,  11,3,31,1,111
21,  5,  11,3,31,1,110
21,  6,  11,3,31,1,109
21,  7,  11,3,31,1,108
21,  8,  11,3,31,1,123
21,  9,  11,3,31,1,122
21, 10,  11,3,31,1,121
21, 11,  11,3,31,1,120
21, 12,  11,3,31,1,107
21, 13,  11,3,31,1,106
21, 14,  11,3,31,1,105
21, 15,  11,3,31,1,104
21, 16,  11,3,31,1,119
21, 17,  11,3,31,1,118
21, 18,  11,3,31,1,117
21, 19,  11,3,31,1,116
21, 20,  11,3,31,1,103
21, 21,  11,3,31,1,102
21, 22,  11,3,31,1,101
21, 23,  11,3,31,1,100
21, 24,  11,3,31,1,115
21, 25,  11,3,31,1,114
21, 26,  11,3,31,1,113
21, 27,  11,3,31,1,112
21, 28,  11,3,31,1,99 
21, 29,  11,3,31,1,98 
21, 30,  11,3,31,1,97 
21, 31,  11,3,31,1,96 
21, 32,  11,3,31,2,63  
21, 33,  11,3,31,2,62  
21, 34,  11,3,31,2,61  
21, 35,  11,3,31,2,60  
21, 36,  11,3,31,2,47  
21, 37,  11,3,31,2,46  
21, 38,  11,3,31,2,45  
21, 39,  11,3,31,2,44  
21, 40,  11,3,31,2,59  
21, 41,  11,3,31,2,58  
21, 42,  11,3,31,2,57  
21, 43,  11,3,31,2,56  
21, 44,  11,3,31,2,43  
21, 45,  11,3,31,2,42  
21, 46,  11,3,31,2,41  
21, 47,  11,3,31,2,40  
21, 48,  11,3,31,2,55  
21, 49,  11,3,31,2,54  
21, 50,  11,3,31,2,53  
21, 51,  11,3,31,2,52  
21, 52,  11,3,31,2,39  
21, 53,  11,3,31,2,38  
21, 54,  11,3,31,2,37  
21, 55,  11,3,31,2,36  
21, 56,  11,3,31,2,51  
21, 57,  11,3,31,2,50  
21, 58,  11,3,31,2,49  
21, 59,  11,3,31,2,48  
21, 60,  11,3,31,2,35  
21, 61,  11,3,31,2,34  
21, 62,  11,3,31,2,33 
21, 63,  11,3,31,2,32
