# map file for dc72
# adopted from ANAPAW by kawase
24,39,  11,7,31,1, 96 
24,38,  11,7,31,1, 97 
24,37,  11,7,31,1, 98 
24,36,  11,7,31,1, 99 
24,31,  11,7,31,1,100
24,30,  11,7,31,1,101
24,29,  11,7,31,1,102
24,28,  11,7,31,1,103
24,15,  11,7,31,1,104
24,14,  11,7,31,1,105
24,13,  11,7,31,1,106
24,12,  11,7,31,1,107
24, 7,  11,7,31,1,108
24, 6,  11,7,31,1,109
24, 5,  11,7,31,1,110
24, 4,  11,7,31,1,111
24,48,  11,7,31,2, 32 
24,63,  11,7,31,2, 33 
24,62,  11,7,31,2, 34 
24,61,  11,7,31,2, 35 
24,56,  11,7,31,2, 36 
24,55,  11,7,31,2, 37 
24,54,  11,7,31,2, 38 
24,53,  11,7,31,2, 39 
24,35,  11,7,31,1,112
24,34,  11,7,31,1,113
24,33,  11,7,31,1,114
24,32,  11,7,31,1,115
24,27,  11,7,31,1,116
24,26,  11,7,31,1,117
24,25,  11,7,31,1,118
24,24,  11,7,31,1,119
24,11,  11,7,31,1,120
24,10,  11,7,31,1,121
24, 9,  11,7,31,1,122
24, 8,  11,7,31,1,123
24, 3,  11,7,31,1,124
24, 2,  11,7,31,1,125
24, 1,  11,7,31,1,126
24, 0,  11,7,31,1,127
24,47,  11,7,31,2, 40 
24,46,  11,7,31,2, 41 
24,45,  11,7,31,2, 42 
24,44,  11,7,31,2, 43 
24,23,  11,7,31,2, 44 
24,22,  11,7,31,2, 45 
24,21,  11,7,31,2, 46 
24,20,  11,7,31,2, 47 
24,60,  11,7,31,2, 48 
24,59,  11,7,31,2, 49 
24,58,  11,7,31,2, 50 
24,57,  11,7,31,2, 51 
24,52,  11,7,31,2, 52 
24,51,  11,7,31,2, 53 
24,50,  11,7,31,2, 54 
24,49,  11,7,31,2, 55 
24,43,  11,7,31,2, 56 
24,42,  11,7,31,2, 57 
24,41,  11,7,31,2, 58 
24,40,  11,7,31,2, 59 
24,19,  11,7,31,2, 60 
24,18,  11,7,31,2, 61 
24,17,  11,7,31,2, 62 
24,16,  11,7,31,2, 63 
