# [category] [id] [[device] [focus] [detector] [geo] [ch]] ...
#  Map   Tx1 Tx2 Ty1 Ty2 Ta
# F3 PPAC 1A sva03
11,   0,  0 63  1 7  16,  0 63  1 7  18,  0 63  1 7  17,  0 63  1 7  19,  0 63  1 7  4
# F3 PPAC 1B sva03
11,   1,  0 63  1 7  20,  0 63  1 7  22,  0 63  1 7  21,  0 63  1 7  23,  0 63  1 7  5
# F3 PPAC 2A sva03
11,   2,  0 63  1 7  24,  0 63  1 7  26,  0 63  1 7  25,  0 63  1 7  27,  0 63  1 7  6
# F3 PPAC 2B sva03
11,   3,  0 63  1 7  28,  0 63  1 7  30,  0 63  1 7  29,  0 63  1 7  31,  0 63  1 7  7
# F7 PPAC 1A sva03
11,   4,  0 63  1 7  48,  0 63  1 7  50,  0 63  1 7  49,  0 63  1 7  51,  0 63  1 7 12
# F7 PPAC 1B sva03
11,   5,  0 63  1 7  52,  0 63  1 7  54,  0 63  1 7  53,  0 63  1 7  55,  0 63  1 7 13
# F7 PPAC 2A sva03
11,   6,  0 63  1 7  56,  0 63  1 7  58,  0 63  1 7  57,  0 63  1 7  59,  0 63  1 7 14
# F7 PPAC 2B sva03
11,   7,  0 63  1 7  60,  0 63  1 7  62,  0 63  1 7  61,  0 63  1 7  63,  0 63  1 7 15
# F8 PPAC 1A sva03
11,   8,  0 63  1 7  80,  0 63  1 7  82,  0 63  1 7  81,  0 63  1 7  83,  0 63  1 7 64
# F8 PPAC 1B sva03
11,   9,  0 63  1 7  84,  0 63  1 7  86,  0 63  1 7  85,  0 63  1 7  87,  0 63  1 7 65
# F8 PPAC 2A sva03
11,  10,  0 63  1 7  88,  0 63  1 7  90,  0 63  1 7  89,  0 63  1 7  91,  0 63  1 7 66
# F8 PPAC 2B sva03
11,  11,  0 63  1 7  92,  0 63  1 7  94,  0 63  1 7  93,  0 63  1 7  95,  0 63  1 7 67
