# map for beamline ppac
# [category] [id] [[device] [seg_detid1] [seg_detid2] [module] [ch]] ....
#  CAMAC Ta Tx1 Ty1 Tx2 Ty2 Qa Qx1 Qy1 Qx2 Qy2 ->
#  Map   Tx1 Tx2 Ty1 Ty2 Ta Qx1 Qx2 Qy1 Qy2 Qa 
1,  0, 0  1 1 0  1, 0  1 1 0  3, 0  1 1 0  2, 0  1 1 0  4, 0  1 1 0  0, 0  1 0 0  1, 0  1 0 0  3, 0  1 0 0  2, 0  1 0 0  4, 0  1 0 0  0 
1,  1, 0  1 1 0  6, 0  1 1 0  8, 0  1 1 0  7, 0  1 1 0  9, 0  1 1 0  5, 0  1 0 0  6, 0  1 0 0  8, 0  1 0 0  7, 0  1 0 0  9, 0  1 0 0  5 
1,  2, 0  2 1 0  1, 0  2 1 0  3, 0  2 1 0  2, 0  2 1 0  4, 0  2 1 0  0, 0  2 0 0  1, 0  2 0 0  3, 0  2 0 0  2, 0  2 0 0  4, 0  2 0 0  0 
1,  3, 0  2 1 0  6, 0  2 1 0  8, 0  2 1 0  7, 0  2 1 0  9, 0  2 1 0  5, 0  2 0 0  6, 0  2 0 0  8, 0  2 0 0  7, 0  2 0 0  9, 0  2 0 0  5 
1,  4, 0  3 1 0  4, 0  3 1 0  6, 0  3 1 0  5, 0  3 1 0  7, 0  3 1 0  0, 0  3 0 0  4, 0  3 0 0  6, 0  3 0 0  5, 0  3 0 0  7, 0  3 0 0  0  
1,  5, 0  3 1 0  8, 0  3 1 0 10, 0  3 1 0  9, 0  3 1 0 11, 0  3 1 0  1, 0  3 0 0  8, 0  3 0 0 10, 0  3 0 0  9, 0  3 0 0 11, 0  3 0 0  1 
1,  6, 0  3 1 0 12, 0  3 1 0 14, 0  3 1 0 13, 0  3 1 0 15, 0  3 1 0  2, 0  3 0 0 12, 0  3 0 0 14, 0  3 0 0 13, 0  3 0 0 15, 0  3 0 0  2 
1,  7, 0  3 1 0 16, 0  3 1 0 18, 0  3 1 0 17, 0  3 1 0 19, 0  3 1 0  3, 0  3 0 0 16, 0  3 0 0 18, 0  3 0 0 17, 0  3 0 0 19, 0  3 0 0  3 
1,  8, 0  4 1 0  1, 0  4 1 0  3, 0  4 1 0  2, 0  4 1 0  4, 0  4 1 0  0, 0  4 0 0  1, 0  4 0 0  3, 0  4 0 0  2, 0  4 0 0  4, 0  4 0 0  0 
1,  9, 0  5 1 0  4, 0  5 1 0  6, 0  5 1 0  5, 0  5 1 0  7, 0  5 1 0  0, 0  5 0 0  4, 0  5 0 0  6, 0  5 0 0  5, 0  5 0 0  7, 0  5 0 0  0 
1, 10, 0  5 1 0  8, 0  5 1 0 10, 0  5 1 0  9, 0  5 1 0 11, 0  5 1 0  1, 0  5 0 0  8, 0  5 0 0 10, 0  5 0 0  9, 0  5 0 0 11, 0  5 0 0  1 
1, 11, 0  5 1 0 12, 0  5 1 0 14, 0  5 1 0 13, 0  5 1 0 15, 0  5 1 0  2, 0  5 0 0 12, 0  5 0 0 14, 0  5 0 0 13, 0  5 0 0 15, 0  5 0 0  2 
1, 12, 0  5 1 0 16, 0  5 1 0 18, 0  5 1 0 17, 0  5 1 0 19, 0  5 1 0  3, 0  5 0 0 16, 0  5 0 0 18, 0  5 0 0 17, 0  5 0 0 19, 0  5 0 0  3 
1, 13, 0  6 1 0  1, 0  6 1 0  3, 0  6 1 0  2, 0  6 1 0  4, 0  6 1 0  0, 0  6 0 0  1, 0  6 0 0  3, 0  6 0 0  2, 0  6 0 0  4, 0  6 0 0  0 